commit amending	úprava revize
stashing	odložení
merge commit	bod sloučení
rebasing	přeskládání
tracking branch	sledující větev
remote-tracking branch	vzdáleně sledovaná větev
fetch	vyzvednout
merge	sloučit
merge	začlenit
remote branch	vzdálená větev
commit	zápis
commit	revize
commit object	objekt revize
commit	objekt revize
push	odeslat
pull	stáhnout
bare repository	holý repozitář
integration-manager workflow	pracovní postup s integračním manažerem	název pro workflow
fast-forward	„rychle vpřed“
forked	odštěpený	ve smyslu "forked project"
forking	odštěpení	ve smyslu "forking on Git"
fork	odštěpený projekt	pokud je použito jako podstatné jméno
fork	odštěpit	pokud je použito jako sloveso
topic branch	tématická větev
cherry-pick	přebírání jednotlivých revizí
cherry-pick	převzetí jednotlivých revizí
cherry-pick	částečné převzetí
fork	odštěpený repozitář
pull request	požadavek na stažení
Commit history	historie revizí
email	elektronická pošta	pokud se hodí rozepsání
email	e-mail	pokud se nehodí rozepisovat
mailing list	poštovní konference
commit message	zpráva k revizi
whitespace	prázdný znak
long-running branch	větev s dlouhou životností
long-term branch	větev s dlouhou životností
longer-term branch	větev s delší životností
check out	získat obsah	ve smyslu "získat obsah větve"
check out	přepnout se	ve smyslu "přepnout se na větev"
diffing	zjišťování rozdílů
option	volba
workflow	pracovní postup
tag	značka
cache	mezipaměť
